0000000000000000
0000000000000000
0000000000000000
0000000000000000
0000000000000000
0000000000000000
0566667000000000
0000000000000000
0000005670000000
0000000000001000
2003030030011003
1111111111111111
-
0000000000000000
0000000000000000
0000000000000005
0000000000000000
0000000566667000
0000000000000000
0567000000000000
0000000000000000
0000000000000000
0000000000000000
0010034003000000
1111111111111111
-
0000000000000000
3330000000030000
6667000005670000
0000000000000005
0000000000000000
0000000000000000
0000000000000000
0000013403100000
0000011111100000
0010000000000001
0310000003330001
1111111111111111
-
0030000000000000
0333000000000000
5666670000000000
0000000000000000
0000000000000000
0000000000300033
0000030000100011
0000010000000000
0100000000000300
0000000001003330
0004000000033333
1111111111111111
-
0000000000000000
0000000000000000
0000000000000000
0000000000000000
0000000000000000
0000000000000000
0000000000000000
0000000000000000
0000000000000000
0000000000000089
00333000000000ab
1111111111111111