0000000000000000
0000000000000000
0000000000000000
0000000000000000
0000000000000000
0000000000000000
0566667000000000
0000000000000000
0000005670000000
0000000000001000
2003030030011003
1111111111111111
-
5666666666666667
0000000000000000
0000000000000000
0000000000000000
0000000000000000
0000000400000000
5666666666666667
0000000000000000
0000000000000000
3333333333333333
0000000000000000
1111111111111111