0000000000000000
0000000000000000
0000000000000000
0000000000000000
0000000000000000
0000000000000000
0000000000000000
0000000000000000
0000001000000000
0000000000001000
2003030030011003
1111111111111111
-
1111111111111111
0000000000000000
0000000000000000
0000000000000000
0000000000000000
0000000400000000
1111111111111111
0000000000000000
0000000000000000
3333333333333333
0000000000000000
1111111111111111